abierto -> geöffnet

abogado -> Anwalt

abuelos -> Großeltern

abrir -> öffnen



acabar de -> gerade

acampar -> campen

actuar -> spielen



adolescente -> Jugendliche

ademas -> außerdem



afortunadamente -> glücklicherweise



agotado -> erschöpft

agradezco -> danke

agradable -> angenehmen



ahora si -> jetzt ja

ahi -> dort



ajedrez -> Schach



aliviado -> erleichtert

alfombra -> Teppich

almorzar -> zu Mittag essen

algunos -> einige

algunas -> einige

alguna -> irgendeine

algun -> irgendein

alla -> dort



amable -> freundlich

amarillo -> gelb



ansioso -> ängstlich

antibiotico -> Antibiotikum

antiguo -> alt

antes -> vorher

antes de -> vor

anuncio -> Stellenangebot

anotar -> notieren

ancho -> weit

anden -> Bahnsteig



a punto de -> gleich

apoyo -> Unterstützung

apagar -> ausmachen

apellido -> Nachname



aquella -> jene



Argentina -> Argentinien

armario -> Schrank

arquitecto -> Architekten

arbol -> Baum


aspiradora -> Staubsauger

ascensor -> Aufzug



avion -> Flugzeug



aquello -> das



alto -> groß

alguien -> jemand

algo -> etwas

alergia -> Allergie


 
aspirina -> Aspirin

asustado -> verängstigt

asado -> gegrillt



auxilio -> Hilfe



aventura -> Abenteuer

avenida -> Allee



ayudar -> helfen



azul -> blau