dar -> geben



de donde eres -> woher kommst du?

descansar -> ausruhen

descanso -> Pausa

desayuno -> Frühstück

desierto -> Wüste

de hecho -> was das betrifft

demasiado -> zu

demasiados -> zu viel

derecho -> rechts

desde -> ab

despues -> später

de ida y vuelta -> hin und zurück

desafortunadamente -> leider

de ahi -> da drüben

de alla -> dort

debajo de -> unter

destinatario -> Empfänger

de repente -> plötzlich

depende -> es kommt darauf an

despertador -> Wecker



dibujar -> zeichnen

dificil -> schwer

divertido -> lustig

dieciseis -> sechzehn

diecisiete -> siebzehn

dieciocho -> achtzehn

distraido -> abgelenkt

disfrutar -> geniessen



donde -> wo

dos -> zwei

domingo -> Sonntag

doler -> schmerzen

doler de estomago -> Bauchschmerzen

doy -> gebe



durazno -> Pfirsich

dulces -> Süßigkeiten

ducharse -> sich duschen

durante -> während

duermo -> schlafe